XXXXXXXXXXXXXXXXXXXXXXXXXXXXXXXXXXXXXXXXXX
XXXXXXXXX.XXXXXXXXXXXXXXXXXXXXXXXXX...f..X
XXXXXXX......XXXXXXXXXXXXXXXXXXXXXX......X
XX.XXXXX.XXXX.XXXXXXXXXXXXXXXXXXXXXXXXXXXX
XXX.XXX..X..X.XXXXXXXXXXXXXXX.XXXXXXX.XXXX
XXXX.X.XXXb.................X.XXXXXX.XXXXX
XXXXX.XXXXXXX.XXXXXX........X.XXXXX.XXXXXX
XXXX.XXXXXX...XXXXXX........X.XXXX....XXXX
XXX.XXXXXX.XXXXXXXXX........X.XXX.XX..XXXX
XX........XXXXXXXXXX........X.XX.XXX.cXXXX
XX.XXXXXXXXXXXXXXXXXXX...........XXX..XXXX
...XXXXXXXXXXXXXXXXXXX...XXXXXX..XX.XXXXXX
.X.XXXXXXXXXXXXXXXXXXX..X.....XX.X.XXXXXXX
.X.XXXXXXXXXXXXXXXXXXX..X.XXX.XX..XXXXXXXX
.X.XXXXXXXXXXXXXXXXXXX..X.X...XX.........X
gX..XX.........XXXXXX..XX.X.XXXXX.......XX
.X.X...XXXX.XXX.X.....XXX.X.XXXXXXX......X
.XX..X.XXX.XXXX.X.........X....XXXXX.....X
.X.XXX....XXXXX.X..e..XXXXXXXX.XXXXXX....X
.XaXXX.XXXXXXXX.X.....XXXXXXXX...........X
.......XXXXXXXX.......XXXXXXXXXXXXXXXXX.dX
XXXXXXXXXXXXXXXXXXXXXXXXXXXXXXXXXXXXXXXXXX
